##################################################################################################################################################################################################################################
#                                                    #                             Magda jest super                                                                                                          #                   #
#           #         #           B                  #                                                                                                           #############                                            #      #
#         #           #                              #                                                                              #                                    #                                   #                   #
#         #           #                              #                     #                         #############                              #                                    #                                           #
#         #           #          #                                         #                                                        #                                                        #############                #      #
#         #                      #                                         #                                                        #                                    #                                           #############
#                                #          #############                               #                                                        #                                    #                                          #
##################################################################################################################################################################################################################################